NO ./textures/colorstone.xpm
SO ./textures/bluestone.xpm
WE ./textures/greystone.xpm
EA ./textures/wood.xpm

F 255,248,220
C 135,206,250

11111111
10E00001
10000001
10000001
10000001
10000001
10000001
10100011
11111111
