NO ./textures/colorstone.xpm
SO ./textures/bluestone.xpm
WE ./textures/greystone.xpm
EA ./textures/wood.xpm

F 255,248,220
C 135,206,250

1111111
1011101
1000001
1000011
10N0001
1010011
1111111
