NO ./textures/colorstone.xpm
SO ./textures/bluestone.xpm
WE ./textures/greystone.xpm
EA ./textures/wood.xpm

F 255,248,220
C 135,206,250

1111111
1001001
1000001
100001111111
100W00000001
100001111111
1001001
1001001
1111111
