NO ./textures/colorstone.xpm
SO ./textures/bluestone.xpm
WE ./textures/greystone.xpm
EA ./textures/wood.xpm

F 255,248,220
C 135,206,250

1111111
1000001
1000001
110N001
1000001
1000001
1111111
